district_num,hwz_sentiment,hwz_comment_count,year,reddit_sentiment,reddit_comment_count,total_count,weighted_sentiment
21,0.0,0,2018,0.14598214285714287,14,14,0.14598214285714287
1,0.08251567009379511,8,2018,0.07993773359590547,676,684,0.07996788489997436
2,0.3170454545454545,1,2018,0.08751811594202898,23,24,0.09708175505050505
3,0.12367784013337885,39,2018,0.0550711553628505,571,610,0.05945748438916297
4,0.09325929607267326,30,2018,0.05184109046184439,813,843,0.05331504795689168
5,0.12245637073251905,61,2018,0.046326525337629786,196,257,0.06439625517844007
6,0.06666666666666668,1,2018,0.0468143158060628,237,238,0.0468977290449729
7,0.07074196146165844,6,2018,0.0,0,6,0.07074196146165844
8,0.09242491883116882,6,2018,0.09553134441513347,96,102,0.09534861349842966
9,0.1954705215419501,10,2018,0.0674064025686818,861,871,0.06887671392313953
10,0.1217127443263807,16,2018,0.0660517436125265,458,474,0.06793059595729795
11,0.14017030423280427,12,2018,-0.04834558823529412,8,20,0.06476394724556492
12,0.12966329322613712,130,2018,0.057500415794411085,297,427,0.07947037847854313
13,0.15380012593104148,51,2018,0.19794408233378827,39,90,0.1729291737055651
14,0.1079429573659322,196,2018,0.07982774891485342,403,599,0.08902738306579072
15,-0.039880952380952385,5,2018,0.0635831854015257,125,130,0.059603795486815006
16,0.13949393478935074,36,2018,0.07353035379563032,356,392,0.07958823368280873
17,0.08714493419038874,22,2018,0.07948013022557414,778,800,0.07969091233460654
18,0.07721888741930558,325,2018,0.046051338938634966,1204,1529,0.05267622661438248
19,0.104078694297461,549,2018,0.07181488348742131,661,1210,0.08645358773098477
20,0.15003987483178866,39,2018,0.05183992376214085,706,745,0.05698059234162578
22,0.10193826902270953,69,2018,0.07474667206504088,1076,1145,0.0763852923183851
23,0.14980804159754127,63,2018,0.04119569137704767,544,607,0.052468472371925916
24,0.10100686563591277,49,2018,0.0744148344118603,315,364,0.07799453092279045
25,0.07945506394508497,50,2018,0.04943616748674376,1009,1059,0.05085349026570227
26,0.2966666666666667,1,2018,-0.02134224163012446,161,162,-0.019379223677675132
27,0.08126941916030263,307,2018,0.05047264802319592,1079,1386,0.05729415504995765
28,0.11691870076175492,37,2018,0.07261594036734098,150,187,0.08138172718334802
1,0.13225057207778956,23,2019,0.11794264772082523,1362,1385,0.11818025224083258
2,0.08507936507936509,3,2019,0.034805817331667516,128,131,0.035957119951843794
3,0.2054714365089913,36,2019,0.08440785401096687,913,949,0.08900036082859478
4,0.1869141239615509,77,2019,0.07401472500570196,328,405,0.09547954900471523
5,0.09385104640731737,165,2019,0.07364928095894008,152,317,0.08416439546677053
6,0.07652281746031747,3,2019,0.0780758877121906,242,245,0.07805687052543296
7,0.0686386714755544,12,2019,0.0,0,12,0.0686386714755544
8,0.0921875,4,2019,0.02226806517024187,715,719,0.02265704672701382
9,0.12258944087130515,58,2019,0.04505884934138101,690,748,0.05107057970065321
10,0.12390533699006387,98,2019,0.07387110077821356,313,411,0.0858014052764163
11,0.11451626050302074,91,2019,0.0,0,91,0.11451626050302074
12,0.10731981921836073,158,2019,0.05589903033009673,693,851,0.06544601581111402
13,0.07851652063392799,61,2019,0.06717653242852709,67,128,0.07258074555766345
14,0.10943938328010684,93,2019,0.047990909916002175,431,524,0.05889684125734136
15,0.12911055731565868,49,2019,0.03946973829226133,281,330,0.05278004172300821
16,0.12209457282441097,68,2019,0.061745115353141124,466,534,0.06943006499367736
17,0.12926299954796616,84,2019,0.07416474143012902,1718,1802,0.07673313969977294
18,0.116814612606772,487,2019,0.0785630338577709,1301,1788,0.08898166856177736
19,0.13445757158830293,666,2019,0.05555043288170762,1069,1735,0.08583985903651598
20,0.09519485430914608,116,2019,0.06207421155077825,1557,1673,0.06437068170019287
21,0.02157407407407407,6,2019,0.058753378667997964,71,77,0.05585628999834155
22,0.10138943686102277,60,2019,0.08408113630093719,1335,1395,0.08482557933577958
23,0.06833800696362223,58,2019,0.0736351583996499,687,745,0.07322276271738197
24,0.07306275797153136,61,2019,0.09115237929510027,664,725,0.08963035598373792
25,0.0499948884755807,23,2019,0.023260044203902774,770,793,0.02403545582842811
26,0.04659618008130708,20,2019,0.013646616541353386,19,39,0.03054382861312451
27,0.09678239661380476,183,2019,0.05733358085891078,1186,1369,0.06260687032797257
28,0.17719498607817774,18,2019,0.11412430361860244,168,186,0.12022791805017424
1,0.13796118332436355,179,2020,0.09902200943998604,2181,2360,0.10197544678121637
2,0.1473574208489382,54,2020,0.08787683248195681,294,348,0.09710657895269531
3,0.13889187002912395,209,2020,0.0852107993097986,1612,1821,0.09137188870042957
4,0.12819507399254795,219,2020,0.10810271854790267,1233,1452,0.11113317711703305
5,0.1546835103644498,734,2020,0.04529838412187948,216,950,0.1298127869240338
6,0.1810636851297736,38,2020,0.06379299246815248,828,866,0.06893881962882407
7,0.15601006609446574,187,2020,0.0,0,187,0.15601006609446574
8,0.0736390712442094,66,2020,0.09734511054507117,783,849,0.09550223823192996
9,0.13307806194145347,212,2020,0.05638252984132379,1203,1415,0.06787330920897572
10,0.13481045935794594,417,2020,0.06866335323867166,1313,1730,0.08460748228591869
11,0.13453388123011653,444,2020,0.04448778720868525,244,688,0.10259892928065543
12,0.11849961401100932,434,2020,0.07971901303782598,1024,1458,0.09126275845782705
13,0.14729446712561314,420,2020,0.0931781281516264,305,725,0.12452828314345321
14,0.13589841920336782,903,2020,0.06568686338855874,1415,2318,0.09303847464859868
15,0.13092455351215285,139,2020,0.1217671133293487,316,455,0.12456466098958996
16,0.10541260996913948,244,2020,0.0396832259635803,895,1139,0.05376397196652713
17,0.0822608540928497,130,2020,0.06846133216758248,1987,2117,0.06930872841240286
18,0.13085099352704566,896,2020,0.06223066860675015,2063,2959,0.08300924621019212
19,0.12677548599492008,997,2020,0.07516398251952303,5532,6529,0.08304523063791341
20,0.1320197732991822,615,2020,0.07055632067726171,2226,2841,0.08386150313501642
21,0.059508189522474414,66,2020,0.05145314754689756,24,90,0.05736017832898725
22,0.10888782733058402,242,2020,0.056494347583243634,3104,3346,0.060283714618167825
23,0.1294197654795115,274,2020,0.07674860613760051,1261,1535,0.08615049386377877
24,0.11509065141184285,467,2020,0.05189037004769399,380,847,0.08673633391671114
25,0.09351696682675023,188,2020,0.044677270906600064,1190,1378,0.051340451482063225
26,0.15644008694810832,17,2020,0.07245900476177201,166,183,0.08026052605777047
27,0.11005485672764484,454,2020,0.05996072670593305,1522,1976,0.07147020799634658
28,0.11580945240087705,37,2020,0.07276087044311627,167,204,0.08056870148447484
1,0.09430673475265773,47,2021,0.06808669089324829,646,693,0.06986496226610867
2,0.06963977452321607,25,2021,0.0499650482615812,2382,2407,0.05016939730875232
3,0.13438526987915214,54,2021,0.113866140373584,403,457,0.11629072022763362
4,0.0847189978619452,107,2021,0.07360179647023951,1023,1130,0.07465448722148953
5,0.139334321508748,136,2021,0.05938568036169095,138,274,0.09906821757336891
6,0.12166594516594514,5,2021,0.10695173433268672,39,44,0.108623803745557
7,0.1703054789501624,52,2021,0.0,0,52,0.1703054789501624
8,0.1036178092329278,11,2021,-0.004956699267810375,135,146,0.0032235719206014047
9,0.1562217280907498,23,2021,0.09989643790849673,125,148,0.10864969246384687
10,0.08297186204623297,44,2021,0.1104569047815193,206,250,0.1056195372601089
11,0.10520832704784773,38,2021,0.08182983682983683,13,51,0.09924910405109985
12,0.09495910478194937,67,2021,0.07652395238906784,495,562,0.07872173746081707
13,0.15624650061420822,47,2021,-0.06999999999999998,5,52,0.1344920294013036
14,0.08853198879377609,48,2021,0.15834546484447912,317,365,0.14916451456931817
15,0.12303477727179025,14,2021,0.049512930815114216,67,81,0.062220410449601436
16,0.07201539201539202,15,2021,0.06973287149503787,182,197,0.06990666747374503
17,0.06276835818502485,9,2021,0.048726214747255484,507,516,0.048971135853728205
18,0.13152517697079916,114,2021,0.0707522957270701,448,562,0.08307989085480162
19,0.12464779699131827,115,2021,0.05395826293631963,644,759,0.06466879839919822
20,0.08221698556073556,40,2021,0.06871847961448511,616,656,0.06954155924535405
21,0.2868960609496324,9,2021,0.16496212121212125,8,17,0.22951538342609773
22,0.12733795771723758,43,2021,0.0653424649735442,823,866,0.06842076311208788
23,0.13454401458557294,55,2021,0.07413571163794097,482,537,0.0803227817722422
24,0.150795276152419,21,2021,0.0777758074752338,642,663,0.0800886413247374
25,0.0888604797979798,12,2021,0.04311171227452632,239,251,0.04529890434736075
26,-0.025054112554112558,1,2021,0.0,0,1,-0.025054112554112558
27,0.0841828878352688,45,2021,0.03141433320072444,319,364,0.03793791825169833
28,0.13311899441199967,11,2021,0.04995750740487583,38,49,0.06862641265137302
